   111111111111111111
111   111           11   
1N      1 11   1111  11   
111       1           1
1111111111 111111111111