NO ./images/gokux64.xpm
SO ./images/chicotex64.xpm
WE ./images/bookshelf.xpm
EA ./images/Bricks.xpm
F 72,72,72
C 255,255,255

111111111111111
100110000000001
100100000000001
100100000111001
100110000001001
100000000000001
101000010000001
101100000000001
100000010000111
10000N000000001
111111111111111
