 NO ./images/no.xpm
SO ./images/so.xpm
WE ./images/we.xpm
EA ./images/ea.xpm

F 72,72,72
C 32,32,32

111111
100001
100001
101101
100001
100011
1N0001
111111