NO ./images/no.xpm
SO ./images/so.xpm
WE ./images/we.xpm
EA ./images/ea.xpm
F 72,72,72
C 255,255,255

1111111111
1000010001
1000000001
11110N0001
1000000111
1000000001
1001110001
1111111111
