NO ./images/no.xpm
SO ./images/so.xpm
WE ./images/we.xpm
EA ./images/ea.xpm
F 72,72,72
C 32,32,32

11111111
10000001
10000001
10E01111
10000001
10001001
10001001
11111111