NO ./images/no.xpm
SO ./images/so.xpm
WE ./images/we.xpm
EA ./images/ea.xpm
F 72,72,72
C 32,32,32

111111111111111111111
100000000000000000001
100000000000000000001
111111000000000000001
100000000000000000001
100001110000000000001
100001 10000000000001
100001 10000000000001
100001 100000E0000001
100001 10000000000001
100001 10000000000001
100001110000000000001
100000000000000001111
111111111111111111111
