NO ./images/no.xpm
SO ./images/so.xpm
WE ./images/we.xpm
EA ./images/ea.xpm
C 255,255,255
F 100,100,100



111111111111111
100000000000001
100000000000001
100000000000001
100000000000001
1000000N0000001
100000000000001
100000000000001
100000000000001
100000000000001
111111111111111
