NO ./images/no.xpm
SO ./images/so.xpm
WE ./images/we.xpm
EA ./images/ea.xpm
C 255,255,255
F 100,100,100



1111111111111111111111111111111111111111111111
1000000000100000000000001000000001           1
1000000000100000000000001000000001  1111     1
1000000000000000000000001000000001 1         1
1000000000100000000000001000000001  1111     1
11111D1111100000000000000000000001           1
100000000010000000000000111111D111     1  1  1
1000000000000000000000000D00000001     1  1  1
11111D1111100000000000000100000001     1111  1
1000000000000000000000000100000001           1
1000000001000000000000000100000001  1        1
1000000001111111111111011111D11111  1        1
10000000010000000000000D0000000001  111111   1
1000000001000000000000010000000001  1    1   1
1000000001000000000000010000000001  111111   1
10000N0001000000000000010000000001           1
1111111111111111111111111111111111111111111111
