NO ./images/no.xpm
SO ./images/so.xpm
WE ./images/we.xpm
EA ./images/ea.xpm
C 255,255,255
F 100,100,100



11111
10001
10E01
11111
